4 4 4 4 4 9 6 6 6 6 6 6 
4 4 4 4 4 5 6 6 6 6 6 6
4 4 4 4 4 5 6 6 6 6 6 6
4 4 4 4 4 5 6 6 6 6 6 6
4 4 4 4 4 5 6 6 6 6 6 6
4 4 4 4 4 5 6 6 6 6 6 6
4 4 4 4 4 4 3 6 6 6 6 6
4 4 4 4 4 4 4 3 6 6 6 6
4 4 4 4 4 4 4 4 3 6 6 6
4 4 4 4 4 4 4 4 4 3 6 6
